grid = [
    [' ', ' ', ' ', ' ', ' ', ' ', ' '],
    [' ', ' ', '┼', ' ', ' ', ' ', ' '],
    [' ', '┌', '┼', ' ', '┌', '┘', ' '],
    ['┌', '┤', '│', '┌', '┴', '┐', '│'],
    [' ', '├', '┼', '┘', '┌', '┼', '┤'],
    ['┌', '┼', '┼', '─', '┼', '┘', ' '],
    ['└', '┘', '└', '─', '┴', '─', ' '],
]
