grid = [
    [' ', ' ', ' ', ' ', ' ', ' ', ' '],
    ['├', '┼', '┼', '┤', ' ', ' ', ' '],
    ['├', '┼', '┘', '│', ' ', ' ', ' '],
    ['├', '┴', ' ', '├', ' ', ' ', ' '],
    ['└', '┐', ' ', '├', '┐', '├', ' '],
    [' ', '┼', '┼', '┴', '┘', '├', '┐'],
    [' ', '┴', '┴', '─', '─', '┴', '┘'],
]
