grid = [
    [' ', ' ', ' ', ' ', ' ', ' ', ' '],
    [' ', ' ', ' ', ' ', ' ', ' ', ' '],
    [' ', ' ', '┌', '┬', '┼', '┐', ' '],
    ['├', '┤', '│', '├', '┘', '│', ' '],
    ['│', '│', '├', '┤', ' ', '├', ' '],
    ['├', '┤', '│', '│', '│', '│', ' '],
    [' ', '└', '┴', '┴', '┴', '┴', '┘'],
]
